1111111111111
1C010000000C1
1000010100001
1P0100E000001
1111111111111
