1111111111111111111111
1C00111C000C00C00000C1
111000C000C00001100111
11110C000C001100000111
1100C000C01100110001C1
110C000C00000000110001
10C000C00011011000C001
1P000C000111100C0100E1
1111111111111111111111
