11111111111111111111111111111111111111111111111111
1P111110001000111111100000011111111000110000000011
10111000101010111111101111011111111010100111111011
1001101110C010000000001111011111100010001111111011
1101101111111011110111111100000000111111C000011011
11010000001000111001111111011101111111110111000011
11010110100011111011111100011100111111110111111111
11010110111111110000000001111110000000000100001111
11000110111110000111110111111111111011110001101111
111011100000001111100000000C1111110011111111101111
11101111011110111100111111100000000011111111101111
1000010001111011110111100000111C111000000011101111
10110101011100000001111011111110001101111000001111
10110C01011101110111111011111111101101111111111111
10111111011101110111111011111111101100011110001111
10111111011101110000000000011100000111011100100111
10000111000001111110111111011101110000011101110001
101101111111011111101111110000011100111C0001111101
10110000011100C00000000111110100000110001111111101
10111111011101111011110111110111110000110001110001
10100000000001111011110000000111110111110100000111
10101111111100000000000111110111100110000011111111
10100011111101111011110111110001101000111000C00111
10111000000000000000000111111101100010011101110111
10111111110111110111110111111101110110011001000111
1011111111000000011100C111110000000100111011011111
1C000011110111110111011111000111101101110000001111
10111000000111110000000000011111001101100111100011
1011101111011111011111110011111101110000110C011011
10111000000111000111100001111100011110111001000011
10111011111000010001101111100001100000110011111111
100100001000111111000C1111101101101111110100010001
11000110001111111111111111100C000011111100010001E1
11111111111111111111111111111111111111111111111111
