11111111111111111111111111111111111111111111111111
1P010101010101010101010101010100101010101010100101
11010101010101010101010101010101010101010101010101
10000000000000000000000000000000000000000000000001
10010101010101010101010101010101010101010101010101
10101010101010101010101010101010101010101010101011
10101010101010101010101010101010101010101010101011
10000000000000000000000000000000000000000000000001
11010101010101010101010101010101010101010101010101
11010101010101010101010101010101010101010101010101
11010101010101010101010101010101010101010101010101
10000000000000000000000000000000000000000000000001
10010101010101010101010101010101010101010101010101
10101010101010101010101010101010101010101010101011
10101010101010101010101010101010101010101010101011
10000000000000000000000000000000000000000000000001
11010101010101010101010101010101010101010101010101
11010101010101010101010101010101010101010101010101
11010101010101010101010101010101010101010101010101
10000000000000000000000000000000000000000000000001
10010101010101010101010101010101010101010101010101
1010101010101010101010C010101010101010101010101011
10101010101010101010101010101010101010101010101011
10000000000000000000000000000000000000000000000001
11010101010101010101010101010101010101010101010101
11010101010101010101010101010101010101010101010101
11010101010101010101010101010101010101010101010101
10000000000000000000000000000000000000000000000001
10010101010101010101010101010101010101010101010101
10101010101010101010101010101010101010101010101011
10101010101010101010101010101010101010101010101011
10000000000000000000000000000000000000000000000001
11010101010101010101010101010101010101010101010101
11010101010101010101010101010101010101010101010101
11010101010101010101010101010101010101010101010101
10000000000000000000000000000000000000000000000001
10010101010101010101010101010101010101010101010101
10101010101010101010101010101010101010101010101011
10101010101010101010101010101010101010101010101011
10000000000000000000000000000000000000000000000001
11010101010101010101010101010101010101010101010101
110101010101010101010101010101010101010101010101E1
11111111111111111111111111111111111111111111111111
