11111111111111111111111111111111111111111111111111
1P111110001000000000000000011111111000000000000001
10111000101010111111101111011111111010100111111001
1001101110C010000000001111011111100010001111111001
1101101111111011110111111100000000111111C000011001
11010000001000111001111111011101111111110111000001
11010110100011111011111100011100111111110111111101
11010110111111110000000001111110000000000100001101
11000110111110000111110111111111111011110001101101
111011100000001111100000000C1111110011111111101101
11101111011110111100111111101100000011111111101101
1000010001111011110111100000111C111000000011101101
10110101011100000001111011111110001101111000001101
10110C01011101110111111011111111101101111111111101
10111111011101110111111011111111101100011110001101
10111111011101110000000000011100000111011100100101
10000111000001111110111111011101110000011101110001
101101111111011111101111110000011100111C0001111111
10110000011100C00000000111110100000110001111111111
10111111011101111011110111110111110000110001110001
10100000000001111011110000000111110111110100000101
10101111111100000000000111110111100110000011111101
10100011111101111011110111110001101000111000C00101
10111000000000000000000111111101100010011101110101
10111111110111110111110111111101110110011001000101
1011111111000000011100C111110000000100111011011101
1C000011110111110111011111000111101101110000001101
10111000000111110000000000000111001101100111100001
1011101111011111011111110011011101110000110C011001
10111000000111000111100001110100011110111001000001
10111011111000010001101101100001100000110011111101
10010000100011011100001101101101101111110100010001
11000110001111000001111100000C000000000000010001E1
11111111111111111111111111111111111111111111111111
