111111111
100010001
10P010001
100000101
101010001
101111E11
10C0110C1
111111111
