11111
10001
101C1
1P1E1
11111
